border_size=1
usage=map

Hh^Fp       , Gs^Fds      , Gs^Fds      , Hh^Fp       , Hh^Fp       , Hh^Fp       , Hh^Fp       , Hh^Fp       , Hh^Fp       , Hh^Fp       , Hh^Fp       , Hh^Fp       , Gs^Fds      , Gs^Fds      , Gs^Fds      , Gs^Fds      , Gs^Fds      , Gs^Fds      , Gs^Fds      , Gs^Fds      , Gs^Fds      , Gs^Fds      , Gs^Fds      , Gs^Fds      , Gs^Fds      , Gs^Fds      , Gs^Fds      , Gg          , Gs^Fds      , Gs^Fds      , Gs^Fds      , Gs^Fds      , Gs^Fds      , Gs^Fds      , Gs^Fds      , Gs^Fds      , Gs^Fds      , Gs^Fds      , Gs^Fds      , Gs^Fds      , Gs^Fds      , Gs^Fds      , Gg          , Gg          , Gg          , Gg          
Hh^Fp       , Gs^Fds      , Gs^Fds      , Gs^Fds      , Gs^Fds      , Gs^Fds      , Gs^Fds      , Gs^Fds      , Gs^Fds      , Gs^Fds      , Gs^Fds      , Gs^Fds      , Gs^Fds      , Gs^Fds      , Gs^Fds      , Gs^Fds      , Hh^Fp       , Gs^Fds      , Gs^Fds      , Gs^Fds      , Gs^Fds      , Gs^Fds      , Gs^Fds      , Gs^Fds      , Gs^Fds      , Gs^Fds      , Gs^Fds      , Gs^Fds      , Gs^Fds      , Gs^Fds      , Gs^Fds      , Gs^Fds      , Gs^Fds      , Gs^Fds      , Gs^Fds      , Gs^Fds      , Gs^Fds      , Gs^Fds      , Gs^Fds      , Gs^Fds      , Gs^Fds      , Gs^Fds      , Gs^Fds      , Gg          , Gg          , Gs^Fds      
Hh^Fp       , Gs^Fds      , Gs^Fds      , Gs^Fds      , Gs^Fds      , Gs^Fds      , Gs^Fds      , Gs^Fds      , Gs^Fds      , Gs^Fds      , Gs^Fds      , Gs^Fds      , Gs^Fds      , Gs^Fds      , Gs^Fds      , Gs^Fds      , Gs^Fds      , Gs^Fds      , Gs^Fds      , Gs^Fds      , Gs^Fds      , Gs^Fds      , Cv          , Gs^Fds      , Cv          , Gs^Fds      , Gs^Fds      , Gs^Fds      , Gs^Fds      , Gs^Fds      , Gs^Fds      , Gs^Fds      , Gs^Fds      , Gs^Fds      , Gs^Fds      , Gs^Fds      , Hh^Fp       , Gs^Fds      , Gs^Fds      , Gs^Fds      , Gs^Fds      , Hh^Fp       , Gs^Fds      , Gs^Fds      , Gs^Fds      , Gs^Fds      
Gs^Fds      , Gs^Fds      , Gs^Fds      , Gs^Fds      , Gs^Fds      , Gs^Fds      , Gs^Fds      , Gs^Fds      , Gs^Fds      , Gs^Fds      , Gs^Fds      , Gs^Fds      , Gs^Fds      , Gs^Fds      , Gs^Fds      , Gs^Fds      , Gs^Fds      , Gs^Fds      , Gg          , Gs^Fds      , Gs^Fds      , Gs^Fds      , Cv          , 2 Kv        , Cv          , Gs^Fds      , Gs^Fds      , Gs^Fds      , Gg^Fet      , Gs^Fds      , Gs^Fds      , Gs^Fds      , Gs^Fds      , Gs^Fds      , Gs^Fds      , Gs^Fds      , Gs^Fds      , Gs^Fds      , Gs^Fds      , Gs^Fds      , Gs^Fds      , Gs^Fds      , Hh^Fp       , Gs^Fds      , Gs^Fds      , Gs^Fds      
Gs^Fds      , Gs^Fds      , Gs^Fds      , Gs^Fds      , Gs^Fds      , Gs^Fds      , Gs^Fds      , Gs^Fds      , Gs^Fds      , Gs^Fds      , Gs^Fds      , Gg          , Gs^Fds      , Gs^Fds      , Gs^Fds      , Gs^Fds      , Gs^Fds      , Gg          , Gg          , Gs^Fds      , Gs^Fds      , Gs^Fds      , Gs^Fds      , Gs^Fds      , Gs^Fds      , Gs^Fds      , Gs^Fds      , Gs^Fds      , Gs^Fds      , Gs^Fds      , Gs^Fds      , Gs^Fds      , Gs^Fds      , Gs^Fds      , Gs^Fds      , Gs^Fds      , Gs^Fds      , Gs^Fds      , Gs^Fds      , Gs^Fds      , Gs^Fds      , Gs^Fds      , Gs^Fds      , Gs^Fds      , Gs^Fds      , Gs^Fds      
Gs^Fds      , Gs^Fds      , Gs^Fds      , Gs^Fds      , Gs^Fds      , Gs^Fds      , Gs^Fds      , Gs^Fds      , Gs^Fds      , Gs^Fds      , Gs^Fds      , Gs^Fds      , Gs^Fds      , Gs^Fds      , Gg          , Gs^Fds      , Gs^Fds      , Gs^Fds      , Gs^Fds      , Gs^Fds      , Gs^Fds      , Gs^Fds      , Gs^Fds      , Gs^Fds      , Gs^Fds      , Gs^Fds      , Gs^Fds      , Gs^Fds      , Gs^Fds      , Gs^Fds      , Gs^Fds      , Gs^Fds      , Gs^Fds      , Gs^Fds      , Gs^Fds      , Gs^Fds      , Gs^Fds      , Gs^Fds      , Gs^Fds      , Gs^Fds      , Gs^Fds      , Gs^Fds      , Gs^Fds      , Gs^Fds      , Gs^Fds      , Gs^Fds      
Gs^Fds      , Gs^Fds      , Gs^Fds      , Gs^Fds      , Gs^Fds      , Gs^Fds      , Gs^Fds      , Gs^Fds      , Gs^Fds      , Gs^Fds      , Gs^Fds      , Gs^Fds      , Gs^Fds      , Gs^Fds      , Gs^Fds      , Gs^Fds      , Gs^Fds      , Gs^Fds      , Gs^Fds      , Gs^Fds      , Gs^Fds      , Hh^Fp       , Gs^Fds      , Gs^Fds      , Gs^Fds      , Gs^Fds      , Gs^Fds      , Gs^Fds      , Gs^Fds      , Gs^Fds      , Gs^Fds      , Gs^Fds      , Gs^Fds      , Gs^Fds      , Hh^Fp       , Gs^Fds      , Gs^Fds      , Gs^Fds      , Gs^Fds      , Gs^Fds      , Gs^Fds      , Gs^Fds      , Hh^Fp       , Gs^Fds      , Gs^Fds      , Gs^Fds      
Gs^Fds      , Gs^Fds      , Gs^Fds      , Gs^Fds      , Gs^Fds      , Gs^Fds      , Gs^Fds      , Gs^Fds      , Gs^Fds      , Gs^Fds      , Gs^Fds      , Gs^Fds      , Gs^Fds      , Gs^Fds      , Gs^Fds      , Gs^Fds      , Gs^Fds      , Gs^Fds      , Gs^Fds      , Gs^Fds      , Gs^Fds      , Gs^Fds      , Gs^Fds      , Gs^Fds      , Gs^Fds      , Hh^Fp       , Gs^Fds      , Gs^Fds      , Gs^Fds      , Gs^Fds      , Gs^Fds      , Gs^Fds      , Gs^Fds      , Gs^Fds      , Gs^Fds      , Gs^Fds      , Gs^Fds      , Gs^Fds      , Gs^Fds      , Gs^Fds      , Gs^Fds      , Gs^Fds      , Gs^Fds      , Gs^Fds      , Gs^Fds      , Gs^Fds      
Gg          , Gs^Fds      , Gg          , Gs^Fds      , Gs^Fds      , Gg^Fet      , Gs^Fds      , Gs^Fds      , Gs^Fds      , Gs^Fds      , Gs^Fds      , Gs^Fds      , Gs^Fds      , Gs^Fds      , Gs^Fds      , Gs^Fds      , Gs^Fds      , Gs^Fds      , Gs^Fds      , Gs^Fds      , Gs^Fds      , Gs^Fds      , Hh^Fp       , Gs^Fds      , Gs^Fds      , Gs^Fds      , Gs^Fds      , Gs^Fds      , Gs^Fds      , Gs^Fds      , Gs^Fds      , Gs^Fds      , Gg          , Gs^Fds      , Gs^Fds      , Gs^Fds      , Gs^Fds      , Gs^Fds      , Gs^Fds      , Gs^Fds      , Gs^Fds      , Gs^Fds      , Gs^Fds      , Gs^Fds      , Gg          , Gg          
Gs^Fds      , Gs^Fds      , Gs^Fds      , Gs^Fds      , Gs^Fds      , Gs^Fds      , Gs^Fds      , Gs^Fds      , Gs^Fds      , Gs^Fds      , Gs^Fds      , Gs^Fds      , Gs^Fds      , Gs^Fds      , Gs^Fds      , Gs^Fds      , Gs^Fds      , Gs^Fds      , Gs^Fds      , Gs^Fds      , Gs^Fds      , Gs^Fds      , Gs^Fds      , Gs^Fds      , Gs^Fds      , Gs^Fds      , Gs^Fds      , Gs^Fds      , Gs^Fds      , Gs^Fds      , Gs^Fds      , Gg          , Gg          , Gs^Fds      , Gs^Fds      , Gs^Fds      , Gs^Fds      , Hh^Fp       , Gs^Fds      , Gs^Fds      , Gs^Fds      , Gs^Fds      , Gs          , Gs          , Gs          , Gs          
Gs^Fds      , Gs^Fds      , Gs^Fds      , Gs^Fds      , Gs^Fds      , Gs^Fds      , Gs^Fds      , Gs^Fds      , Gs^Fds      , Gs^Fds      , Gs^Fds      , Gs^Fds      , Gg^Fet      , Gs^Fds      , Gs^Fds      , Gs^Fds      , Gs^Fds      , Gs^Fds      , Gs^Fds      , Gs^Fds      , Gg          , Gs^Fds      , Gs^Fds      , Gs^Fds      , Gs^Fds      , Gs^Fds      , Gs^Fds      , Gs^Fds      , Gs^Fds      , Gs^Fds      , Gs^Fds      , Gs^Fds      , Gs^Fds      , Gs^Fds      , Gs^Fds      , Gs^Fds      , Gs^Fds      , Gs^Fds      , Gs^Fds      , Gs^Fds      , Gs^Fds      , Gs          , Gs^Fds      , Gs          , Gs          , Gs          
Gs^Fds      , Gs^Fds      , Gs^Fds      , Gs^Fds      , Gs^Fds      , Gs^Fds      , Gs^Fds      , Gg          , Gs^Fds      , Gs^Fds      , Gs^Fds      , Gs^Fds      , Gs^Fds      , Gs^Fds      , Gs^Fds      , Gs^Fds      , Gs^Fds      , Gs^Fds      , Gg          , Gg          , Gg          , Gs^Fds      , Gs^Fds      , Gs^Fds      , Gg^Fet      , Gs^Fds      , Gs^Fds      , Gs^Fds      , Gs^Fds      , Gs^Fds      , Gs^Fds      , Gs^Fds      , Gs^Fds      , Gs^Fds      , Gs^Fds      , Gs^Fds      , Gs^Fds      , Gs^Fds      , Gs^Fds      , Gs^Fds      , Gs^Fds      , Gs^Fds      , Gs^Fds      , Gs^Fds      , Gs^Fds      , Gs          
Gs^Fds      , Gs^Fds      , Gs^Fds      , Gs^Fds      , Gs^Fds      , Gs^Fds      , Gs^Fds      , Gs^Fds      , Gs^Fds      , Gs^Fds      , Gs^Fds      , Gs^Fds      , Gs^Fds      , Gs^Fds      , Gs^Fds      , Hh^Fp       , Gs^Fds      , Gs^Fds      , Gs^Fds      , Gg          , Gs^Fds      , Gs^Fds      , Gs^Fds      , Gs^Fds      , Gs^Fds      , Gs^Fds      , Gs^Fds      , Gs^Fds      , Gs^Fds      , Gs^Fds      , Gs^Fds      , Gs^Fds      , Gs^Fds      , Gs^Fds      , Gs^Fds      , Gs^Fds      , Gs^Fds      , Gs^Fds      , Hh^Fp       , Gs^Fds      , Hh^Fp       , Gs^Fds      , Gs^Fds      , Gs^Fds      , Gs^Fds      , Gs          
Gs^Fds      , Gs^Fds      , Gs^Fds      , Gg^Fet      , Gs^Fds      , Gs^Fds      , Gs^Fds      , Gs^Fds      , Gs^Fds      , Gs^Fds      , Gs^Fds      , Gs^Fds      , Gs^Fds      , Gs^Fds      , Gs^Fds      , Gs^Fds      , Gs^Fds      , Gs^Fds      , Gs^Fds      , Gs^Fds      , Gs^Fds      , Gs^Fds      , Gs^Fds      , Gs^Fds      , Gs^Fds      , Gs^Fds      , Gs^Fds      , Gs^Fds      , Gs^Fds      , Gs^Fds      , Gs^Fds      , Gs^Fds      , Gs^Fds      , Gs^Fds      , Gs^Fds      , Gs^Fds      , Gg          , Gs^Fds      , Gs^Fds      , Gs^Fds      , Gs^Fds      , Gs^Fds      , Gs^Fds      , Gs^Fds      , Gs^Fds      , Gs          
Gs^Fds      , Gs^Fds      , Gs^Fds      , Gs^Fds      , Gs^Fds      , Gs^Fds      , Gs^Fds      , Gg          , Gs^Fds      , Gs^Fds      , Gg^Fet      , Gs^Fds      , Gs^Fds      , Gs^Fds      , Gs^Fds      , Gs^Fds      , Gg^Fet      , Gs^Fds      , Gs^Fds      , Gs^Fds      , Gs^Fds      , Gs^Fds      , Gs^Fds      , Gs^Fds      , Gg          , Gs^Fds      , Gs^Fds      , Gs^Fds      , Hh^Fp       , Hh^Fp       , Gs^Fds      , Gs^Fds      , Hh^Fp       , Gs^Fds      , Gs^Fds      , Gs^Fds      , Gs^Fds      , Gs^Fds      , Gs^Fds      , Gs^Fds      , Gs^Fds      , Gs^Fds      , Gs^Fds      , Gs^Fds      , Rp          , Rp          
Gs^Fds      , Gs^Fds      , Gs^Fds      , Gs^Fds      , Gs^Fds      , Gs^Fds      , Gs^Fds      , Gs^Fds      , Gs^Fds      , Gs^Fds      , Gs^Fds      , Gs^Fds      , Gs^Fds      , Gs^Fds      , Gs^Fds      , Gs^Fds      , Gs^Fds      , Gs^Fds      , Gs^Fds      , Gs^Fds      , Gs^Fds      , Gs^Fds      , Gs^Fds      , Gs^Fds      , Gs^Fds      , Gs^Fds      , Gs^Fds      , Gs^Fds      , Gs^Fds      , Gs^Fds      , Gs^Fds      , Gs^Fds      , Gs^Fds      , Gs^Fds      , Gs^Fds      , Gs^Fds      , Gs^Fds      , Gs^Fds      , Gs^Fds      , Gs^Fds      , Gs^Fds      , Gs^Fds      , Rp          , Rp          , Ss          , Gs          
Gs          , Gs^Fds      , Gs          , Gs^Fds      , Gs^Fds      , Gs^Fds      , Gs^Fds      , Gs^Fds      , Gs^Fds      , Gs^Fds      , Gs^Fds      , Gs^Fds      , Gs^Fds      , Gs^Fds      , Gs^Fds      , Gs^Fds      , Gs^Fds      , Gs^Fds      , Gs^Fds      , Gs^Fds      , Gs^Fds      , Gs^Fds      , Gs^Fds      , Gs^Fds      , Gs^Fds      , Gs^Fds      , Gs^Fds      , Gs^Fds      , Gg          , Gs^Fds      , Gs^Fds      , Gs^Fds      , Gs^Fds      , Gs^Fds      , Gs^Fds      , Gs^Fds      , Gs^Fds      , Gs          , Gs          , Gs^Fds      , Gs          , Gs          , Rp          , Gs          , Ss          , Ss          
Gs          , Gs          , Gs          , Gs          , Gs          , Gs          , Gs          , Gs^Fds      , Gs^Fds      , Gs^Fds      , Gs^Fds      , Gs^Fds      , Gs^Fds      , Gs^Fds      , Gs^Fds      , Hh^Fp       , Hh^Fp       , Gs^Fds      , Gs^Fds      , Gs^Fds      , Gs^Fds      , Gg          , Gg          , Gs^Fds      , Gs^Fds      , Gs^Fds      , Gs^Fds      , Gs^Fds      , Gs^Fds      , Gs^Fds      , Gs^Fds      , Gs^Fds      , Gs^Fds      , Gs^Fds      , Gs^Fds      , Gs^Fds      , Gs          , Gs          , Gs          , Gs          , Rp          , Rp          , Ss          , Ss          , Ss          , Ss          
Gs^Fds      , Gs          , Gs^Es       , Gs^Es       , Gs          , Gs^Es       , Gs          , Gs          , Gs          , Gs          , Gs          , Gs^Fds      , Gs          , Gs^Fds      , Gs          , Gs^Fds      , Gs^Fds      , Gs^Fds      , Gs^Fds      , Gs^Fds      , Gs^Fds      , Gs^Fds      , Gs^Fds      , Gs^Fds      , Gs^Fds      , Gs^Fds      , Gs^Fds      , Gs^Fds      , Gs^Fds      , Gs^Fds      , Gs          , Gs^Fds      , Gs          , Gs^Fds      , Gs          , Gs          , Gs          , Gs          , Rp          , Rp          , Ss          , Ss          , Ss          , Ss          , Ss          , Ss          
Gs^Fds      , Gs^Fds      , Gs^Es       , Gs^Es       , Gs          , Gs^Es       , Gs^Fds      , Gs          , Gs          , Gs^Es       , Gs          , Gs          , Gs          , Gs          , Gs          , Gs^Fds      , Gs^Fds      , Gs^Fds      , Gs          , Gs^Fds      , Gs^Fds      , Gs^Fds      , Gs^Fds      , Gs^Fds      , Gs          , Gs          , Gs          , Gs^Fds      , Gs          , Gs          , Gs          , Gs          , Gs          , Gs          , Rp          , Rp          , Rp          , Rp          , Ss          , Ss          , Ss          , Ss          , Wog         , Wog         , Wog         , Gs          
Gs^Fds      , Gs^Fds      , Gs^Fds      , Gs^Es       , Gs          , Gs^Es       , Gs^Fds      , Gs^Fds      , Gs          , Gs          , Gs^Es       , Gs^Fds      , Gs^Fds      , Gs          , Gs^Es       , Gs          , Gs          , Gs          , Gs          , Gs          , Gs          , Gs^Fds      , Gs          , Gs          , Rp          , Rp          , Rp          , Gs          , Rp          , Gs          , Rp          , Rp          , Rp          , Rp          , Gs          , Gs          , Gs          , Ss          , Ss          , Ss          , Ss          , Wog         , Wog         , Wog         , Wog         , Wog         
Gs^Fds      , Gs^Fds      , Gs          , Gs^Es       , Gs          , Gs^Fds      , Gs^Fds      , Gs^Fds      , Gs          , Gs          , Gs          , Gs^Es       , Gs^Es       , Gs^Es       , Gs          , Gs^Es       , Gs          , Gs          , Gs          , Gs          , Rp          , Rp          , Rp          , Rp          , Gs^Fds      , Gs          , Gs          , Rp          , Gs          , Rp          , Gs          , Rp          , Gs          , Gs          , Gs^Fds      , Gs          , Ss          , Ss          , Ss          , Ss          , Ss          , Wog         , Wog         , Wog         , Wog         , Wog         
Gs^Fds      , Gs^Fds      , Gs^Es       , Gs          , Gs^Es       , Gs^Es       , Gs          , Gs          , Wwg         , Gs          , Gs          , Gs          , Gs^Es       , Gs^Es       , Gs          , Gs          , Gs          , Gs          , Rp          , Rp          , Gs          , Rp          , Gs          , Gs          , Gs^Fds      , Gs^Fds      , Gs^Fds      , Gs          , Gs          , Gs          , Gs          , Gs          , Gs          , Gs^Fds      , Gs^Fds      , Gs^Fds      , Ss          , Ss          , Wog         , Wog         , Wog         , Wog         , Wog         , Wog         , Wog         , Wog         
Gs          , Gs^Es       , Gs          , Gs          , Gs^Es       , Gs          , Wwg         , Wwg         , Wog         , Wwg         , Wwg         , Gs          , Gs          , Gs^Es       , Gs          , Gs          , Rp          , Rp          , Gs          , Gs          , Gs          , Gs          , Gs          , Gs^Fds      , Gs^Fds      , Gs^Fds      , Gs^Fds      , Gs          , Gs          , Gs          , Gs          , Gs          , Gs^Fds      , Gs^Fds      , Gs^Fds      , Ss          , Ss          , Ss          , Wog         , Wog         , Wog         , Wog         , Wog         , Wog         , Wog         , Wog         
Gs          , Gs          , Ss          , Gs          , Gs          , Gs          , Wwg         , Wog         , Khr         , Wog         , Wog         , Gs          , Gs          , Gs          , Rp          , Rp          , Gs          , Gs          , Gs          , Gs          , Gs^Fds      , Gs          , Gs          , Gs          , Gs          , Gs^Fds      , Gs          , Gs          , Gs          , Gs          , Gs          , Gs          , Gs^Fds      , Gs^Fds      , Ss          , Ss          , Ss          , Ss          , Wog         , Wog         , Wog         , Wog         , Wog         , Wog         , Wog         , Wog         
Ss          , Ss          , Wwg         , Wwg         , Wwg         , Wwg         , Wog         , Wog         , Chr         , Wog         , Wog         , Wog         , Wog^Bw/r    , Rp          , Wwg         , Gs          , Gs          , Gs          , Gs          , Gs^Fds      , Hh^Fp       , Gs          , Gs          , Gs          , Gs          , Gs          , Gs          , Gs          , Gs          , Gs          , Gs          , Gs          , Gs          , Ss          , Ss          , Ss          , Wog         , Wog         , Wog         , Wog         , Wog         , Wog         , Wog         , Wog         , Wog         , Wog         
Wwg         , Wwg         , Wwg         , Wwg         , Wwg         , Wwg         , Chr         , Chr         , Chr^Es      , Wog         , Wog^Bw/r    , Wog^Bw/r    , Wog         , Wog         , Wog         , Wwg         , Wwg         , Gs          , Gs          , Gs          , Gs          , Gs          , Gs          , Gs          , Gs          , Gs          , Gs          , Gs          , Gs          , Gs          , Gs          , Gs          , Ss          , Ss          , Ss          , Wog         , Wog         , Wog         , Wog         , Wog         , Wog         , Wog         , Wog         , Wog         , Wog         , Wog         
Ss          , Ss          , Wwg         , Khs         , Chr^Em      , Chr^Es      , Chr^Em      , Rr^Vhc      , Chr^Es      , Chr^Es      , Chr^Es      , Wog         , Chr^Es      , Khr         , Khr         , Wog         , Wwg         , Gs          , Gs          , Gs          , Gs          , Gs          , Gs^Fds      , Gs          , Gs^Fds      , Hh^Fp       , Gs^Fds      , Gs          , Gs          , Gs          , Ss          , Ss          , Ss          , Ss          , Gd^Fetd     , Wog         , Wog         , Wog         , Wog         , Wog         , Wog         , Wog         , Wog         , Wog         , Wog         , Wog         
Wwg         , Wwg         , Wwg         , Chw         , Wwg         , Chr^Em      , Chr^Es      , Chr^Em      , Rr^Vhc      , Chr^Es      , Rr^Vhc      , Chr^Es      , Chr^Em      , Chr^Es      , Khr         , Wog         , Wwg         , Gs          , Gs          , Gs          , Gs          , Gs          , Gs^Fds      , Gs^Fds      , Gs^Fds      , Gs^Fds      , Gs          , Gs          , Gs          , Gs^Es       , Ss          , Ss          , Ss          , Ss          , Wog         , Wog         , Wog         , Wog         , Wog         , Wog         , Wog         , Wog         , Wog         , Wog         , Wog         , Wog         
Ss          , Wwg         , Gg          , Wwg         , Ss          , Wwg         , Wwg         , Chr         , Chr         , Chr^Es      , Chr         , Chr^Em      , Wwg         , Wwg         , Wog         , Wog         , Wwg         , Gs          , Gs          , Gs          , Gs          , Gs^Fds      , Gs^Fds      , Gs^Fds      , Gs^Fds      , Gs          , Gs          , Gs          , Gs          , Ss          , Gd^Fetd     , Ss          , Ss          , Wog         , Wog         , Wog         , Wog         , Wog         , Wog         , Wog         , Wog         , Wog         , Wog         , Wog         , Wog         , Wog         
Ss          , Ss          , Gg          , Ss          , Ss          , Ss          , Ss          , Wwg         , Wwg         , Chr^Es      , Wwg         , Wwg         , Gs          , Gs          , Gs          , Wwg         , Gs          , Gs          , Gs^Es       , Gs          , Gs          , Gs^Fds      , Gs^Fds      , Gs^Fds      , Gs^Fds      , Gs          , Gs          , Gs^Es       , Gs^Es       , Ss          , Ss          , Ss          , Ss          , Wog         , Wog         , Wog         , Wog         , Wog         , Wog         , Wog         , Wog         , Wog         , Wog         , Wog         , Wog         , Wog         
Ss          , Ss          , Gg          , Ss          , Ss          , Ss          , Ss          , Wwg         , Wwg         , Khs         , Wwg         , Gs          , Gs          , Gs          , Gs          , Gs          , Gs          , Gs^Es       , Gs^Es       , Gs^Es       , Gs^Es       , Gs^Fds      , Gs^Fds      , Gs^Fds      , Gs          , Gs          , Gs          , Gs          , Ss          , Ss          , Ss          , Ss          , Ss          , Wog         , Wog         , Wog         , Wog         , Wog         , Wog         , Wog         , Wog         , Hh          , Wog         , Wog         , Wog         , Wog         
Ss          , Ss          , Gg          , Gg          , Ss          , Ss          , Ss          , Ss          , Ss          , Wwg         , Gs          , Gs          , Gs          , Gs          , Gs          , Gs          , Gs^Es       , Gs          , Gs          , Gs^Es       , Gs          , Gs^Es       , Gs          , Gs^Fds      , Gs          , Gs^Es       , Gs          , Gs^Es       , Ss          , Ss          , Ss          , Ss          , Wog         , Wog         , Wog         , Wog         , Wog         , Wog         , Wog         , Wog         , Wog         , Wog         , Wog         , Wog         , Wog         , Wog         
Ss          , Ss          , Gg          , Gg          , Gg          , Ss          , Ss          , Ss          , Gs          , Gs          , Gs          , Gs          , Gs          , Gs          , Gs^Es       , Gs^Es       , Gs          , Gs          , Gs          , Gs          , Gs          , Gs          , Gs          , Gs          , Gs^Es       , Gs^Es       , Gs^Es       , Ss          , Ss          , Ss          , Ss          , Wog         , Wog         , Wog         , Wog         , Wog         , Wog         , Wog         , Wog         , Wog         , Wog         , Wog         , Wog         , Wog         , Wog         , Wog         
Ss          , Ss          , Ss          , Gg          , Gg          , Gg          , Ss          , Ss          , Gs          , Gs          , Gs          , Gs          , Gs^Es       , Gs^Es       , Gs^Es       , Gs          , Gs          , Gs          , Gs          , Gs          , Gs          , Gs          , Gs          , Gs          , Gs          , Gs          , Gs^Es       , Ss          , Ss          , Ss          , Wog         , Wog         , Wog         , Wog         , Wog         , Wog         , Wog         , Wog         , Wog         , Wog         , Wog         , Wog         , Hh          , Wog         , Wog         , Wog         
Ss          , Ss          , Ss          , Gg^Es       , Gg^Es       , Gg          , Ss          , Ss          , Gs          , Gs          , Gs          , Gs^Es       , Gs          , Gs          , Gs          , Gs^Es       , Gs          , Gs          , Ce          , Gs          , Ce          , Gs          , Ce          , Gs          , Gs          , Gs          , Gs^Es       , Gd^Fetd     , Wog         , Wog         , Wog         , Wog         , Wog         , Wog         , Wog         , Wog         , Hh          , Hh          , Wog         , Wog         , Hh          , Hh          , Hh          , Wog         , Wog         , Wog         
Gs          , Ss          , Ss          , Ss          , Gg^Es       , Gg          , Gs          , Gs^Es       , Gs          , Gs          , Gs          , Gs          , Gs          , Gs          , Gs          , Gs          , Gs          , Gs          , Gs          , Ce          , 1 Ke        , Ce          , Gs          , Gs          , Gs          , Gs^Es       , Gs^Es       , Wog         , Wog         , Wog         , Wog         , Wog         , Wog         , Wog         , Wog         , Wog         , Wog         , Wog         , Wog         , Wog         , Wog         , Hh          , Wog         , Wog         , Wog         , Wog         
Ss          , Ss          , Gs          , Ss          , Ss          , Gs^Es       , Gs          , Gs          , Gs          , Gs^Es       , Gs          , Gs          , Gs          , Gs          , Gs          , Gs          , Gs          , Gs          , Gs          , Gs          , Gs          , Gs          , Gs          , Gs          , Gs          , Gs^Es       , Gs^Es       , Wog         , Wog         , Wog         , Wog         , Wog         , Wog         , Wog         , Wog         , Wog         , Wog         , Wog         , Wog         , Wog         , Wog         , Wog         , Wog         , Wog         , Wog         , Wog         
