border_size=1
usage=map

Gs^Es       , Gs^Es       , Gs^Es       , Gs^Es       , Gs^Es       , Gs^Es       , Gs^Es       , Gs^Es       , Gs^Es       , Gs^Es       , Gs^Es       , Gs^Es       , Gs^Es       , Gs^Es       , Gs^Es       , Gs^Es       , Gs^Es       , Gs^Es       , Gs^Es       , Gs^Es       , Gs^Es       , Gs^Es       , Gs^Es       , Gs^Es       , Gs^Es       , Gs^Es       , Gs^Es       , Gs^Es       , Gs^Es       , Gs^Es       , Gs^Es       , Gs^Es       , Gs^Es       , Gs^Es       , Gs^Es       , Gs^Es       , Gs^Es       , Gs^Es       , Gs^Es       , Gs^Es       , Gs^Es       , Gs^Es       , Gs^Es       , Gs^Es       , Gs^Es       , Gs^Es       
Gs^Es       , Gs^Es       , Gs^Es       , Gs^Es       , Gs^Es       , Gs^Es       , Gs^Es       , Gs^Es       , Gs^Es       , Gs^Es       , Gs^Es       , Gs^Es       , Gs^Es       , Gs^Es       , Gs^Es       , Gs^Es       , Gs^Es       , Gs^Es       , Gs^Es       , Gs^Es       , Gs^Es       , Gs^Es       , Gs^Es       , Gs^Es       , Gs^Es       , Gs^Es       , Gs^Es       , Gs^Es       , Gs^Es       , Gs^Es       , Gs^Es       , Gs^Es       , Gs^Es       , Gs^Es       , Gs^Es       , Gs^Es       , Gs^Es       , Gs^Es       , Gs^Es       , Gs^Es       , Gs^Es       , Gs^Es       , Gs^Es       , Gs^Es       , Gs^Es       , Gs^Es       
Gs^Es       , Gs^Es       , Gs^Es       , Gs^Es       , Gs^Es       , Gs^Es       , Gs^Es       , Gs^Es       , Gs^Es       , Gs^Es       , Gs^Es       , Gs^Es       , Gs^Es       , Gs^Es       , Gs^Es       , Gs^Es       , Gs^Es       , Gs^Es       , Gs^Es       , Gs^Es       , Gs^Es       , Gs^Es       , Gs^Es       , Gs^Es       , Gs^Es       , Gs^Es       , Gs^Es       , Gs^Es       , Gs^Es       , Gs^Es       , Gs^Es       , Gs^Es       , Gs^Es       , Gs^Es       , Gs^Es       , Gs^Es       , Gs^Es       , Gs^Es       , Gs^Es       , Gs^Es       , Gs^Es       , Gs^Es       , Gs^Es       , Gs^Es       , Gs^Es       , Gs^Es       
Gs^Es       , Gs^Es       , Gs^Es       , Gs^Es       , Gs^Es       , Gs^Es       , Gs^Es       , Gs^Es       , Gs^Es       , Gs^Es       , Gs^Es       , Gs^Es       , Gs^Es       , Gs^Es       , Gs^Es       , Gs^Es       , Gs^Es       , Gs^Es       , Gs^Es       , Gs^Es       , Gs^Es       , Gs^Es       , Gs^Es       , Gs^Es       , Gs^Es       , Gs^Es       , Gs^Es       , Gs^Es       , Gs^Es       , Gs^Es       , Gs^Es       , Gs^Es       , Gs^Es       , Gs^Es       , Gs^Es       , Gs^Es       , Gs^Es       , Gs^Es       , Gs^Es       , Gs^Es       , Gs^Es       , Gs^Es       , Gs^Es       , Gs^Es       , Gs^Es       , Gs^Es       
Gs^Es       , Gs^Es       , Gs^Es       , Gs^Es       , Gs^Es       , Gs^Es       , Gs^Es       , Gs^Es       , Gs^Es       , Gs^Es       , Gs^Es       , Gs^Es       , Gs^Es       , Gs^Es       , Gs^Es       , Gs^Es       , Gs^Es       , Gs^Es       , Gs^Es       , Gs^Es       , Gs^Es       , Gs^Es       , Gs^Es       , Gs^Es       , Gs^Es       , Gs^Es       , Gs^Es       , Gs^Es       , Gs^Es       , Gs^Es       , Gs^Es       , Gs^Es       , Gs^Es       , Gs^Es       , Gs^Es       , Gs^Es       , Gs^Es       , Gs^Es       , Gs^Es       , Gs^Es       , Gs^Es       , Gs^Es       , Gs^Es       , Gs^Es       , Gs^Es       , Gs^Es       
Gs^Es       , Gs^Es       , Gs^Es       , Gs^Es       , Gs^Es       , Gs^Es       , Gs^Es       , Gs^Es       , Gs^Es       , Gs^Es       , Gs^Es       , Gs^Es       , Gs^Es       , Gs^Es       , Gs^Es       , Gs^Es       , Gs^Es       , Gs^Es       , Gs^Es       , Gs^Es       , Gs^Es       , Gs^Es       , Gs^Es       , Gs^Es       , Gs^Es       , Gs^Es       , Gs^Es       , Gs^Es       , Gs^Es       , Gs^Es       , Gs^Es       , Gs^Es       , Gs^Es       , Gs^Es       , Gs^Es       , Gs^Es       , Gs^Es       , Gs^Es       , Gs^Es       , Gs^Es       , Gs^Es       , Gs^Es       , Gs^Es       , Gs^Es       , Gs^Es       , Gs^Es       
Gs^Es       , Gs^Es       , Gs^Es       , Gs^Es       , Gs^Es       , Gs^Es       , Gs^Es       , Gs^Es       , Gs^Es       , Gs^Es       , Gs^Es       , Gs^Es       , Gs^Es       , Gs^Es       , Gs^Es       , Gs^Es       , Gs^Es       , Gs^Es       , Gs^Es       , Gs^Es       , Gs^Es       , Gs^Es       , Gs^Es       , Gs^Es       , Gs^Es       , Gs^Es       , Gs^Es       , Gs^Es       , Gs^Es       , Gs^Es       , Gs^Es       , Gs^Es       , Gs^Es       , Gs^Es       , Gs^Es       , Gs^Es       , Gs^Es       , Gs^Es       , Gs^Es       , Gs^Es       , Gs^Es       , Gs^Es       , Gs^Es       , Gs^Es       , Gs^Es       , Gs^Es       
Gs^Es       , Gs^Es       , Gs^Es       , Gs^Es       , Gs^Es       , Gs^Es       , Gs^Es       , Gs^Es       , Gs^Es       , Gs^Es       , Gs^Es       , Gs^Es       , Gs^Es       , Gs^Es       , Gs^Es       , Gs^Es       , Gs^Es       , Gs^Es       , Gs^Es       , Gs^Es       , Gs^Es       , Gs^Es       , Gs^Es       , Gs^Es       , Gs^Es       , Gs^Es       , Gs^Es       , Gs^Es       , Gs^Es       , Gs^Es       , Gs^Es       , Gs^Es       , Gs^Es       , Gs^Es       , Gs^Es       , Gs^Es       , Gs^Es       , Gs^Es       , Gs^Es       , Gs^Es       , Gs^Es       , Gs^Es       , Gs^Es       , Gs^Es       , Gs^Es       , Gs^Es       
Gs^Es       , Gs^Es       , Gs^Es       , Gs^Es       , Gs^Es       , Gs^Es       , Gs^Es       , Gs^Es       , Gs^Es       , Gs^Es       , Gs^Es       , Gs^Es       , Gs^Es       , Gs^Es       , Gs^Es       , Gs^Es       , Gs^Es       , Gs^Es       , Gs^Es       , Gs^Es       , Gs^Es       , Gs^Es       , Gs^Es       , Gs^Es       , Gs^Es       , Gs^Es       , Gs^Es       , Gs^Es       , Gs^Es       , Gs^Es       , Gs^Es       , Gs^Es       , Gs^Es       , Gs^Es       , Gs^Es       , Gs^Es       , Gs^Es       , Gs^Es       , Gs^Es       , Gs^Es       , Gs^Es       , Gs^Es       , Gs^Es       , Gs^Es       , Gs^Es       , Gs^Es       
Gs^Es       , Gs^Es       , Gs^Es       , Gs^Es       , Gs^Es       , Gs^Es       , Gs^Es       , Gs^Es       , Gs^Es       , Gs^Es       , Gs^Es       , Gs^Es       , Gs^Es       , Gs^Es       , Gs^Es       , Gs^Es       , Gs^Es       , Gs^Es       , Gs^Es       , Gs^Es       , Gs^Es       , Gs^Es       , Gs^Es       , Gs^Es       , Gs^Es       , Gs^Es       , Gs^Es       , Gs^Es       , Gs^Es       , Gs^Es       , Gs^Es       , Gs^Es       , Gs^Es       , Gs^Es       , Gs^Es       , Gs^Es       , Gs^Es       , Gs^Es       , Gs^Es       , Gs^Es       , Gs^Es       , Gs^Es       , Gs^Es       , Gs^Es       , Gs^Es       , Gs^Es       
Gs^Es       , Gs^Es       , Gs^Es       , Gs^Es       , Gs^Es       , Gs^Es       , Gs^Es       , Gs^Es       , Gs^Es       , Gs^Es       , Gs^Es       , Gs^Es       , Gs^Es       , Gs^Es       , Gs^Es       , Gs^Es       , Gs^Es       , Gs^Es       , Gs^Es       , Gs^Es       , Gs^Es       , Gs^Es       , Gs^Es       , Gs^Es       , Gs^Es       , Gs^Es       , Gs^Es       , Gs^Es       , Gs^Es       , Gs^Es       , Gs^Es       , Gs^Es       , Gs^Es       , Gs^Es       , Gs^Es       , Gs^Es       , Gs^Es       , Gs^Es       , Gs^Es       , Gs^Es       , Gs^Es       , Gs^Es       , Gs^Es       , Gs^Es       , Gs^Es       , Gs^Es       
Gs^Es       , Gs^Es       , Gs^Es       , Gs^Es       , Gs^Es       , Gs^Es       , Gs^Es       , Gs^Es       , Gs^Es       , Gs^Es       , Gs^Es       , Gs^Es       , Gs^Es       , Gs^Es       , Gs^Es       , Gs^Es       , Gs^Es       , Gs^Es       , Gs^Es       , Gs^Es       , Gs^Es       , Gs^Es       , Gs^Es       , Gs^Es       , Gs^Es       , Gs^Es       , Gs^Es       , Gs^Es       , Gs^Es       , Gs^Es       , Gs^Es       , Gs^Es       , Gs^Es       , Gs^Es       , Gs^Es       , Gs^Es       , Gs^Es       , Gs^Es       , Gs^Es       , Gs^Es       , Gs^Es       , Gs^Es       , Gs^Es       , Gs^Es       , Gs^Es       , Gs^Es       
Gs^Es       , Gs^Es       , Gs^Es       , Gs^Es       , Gs^Es       , Gs^Es       , Gs^Es       , Gs^Es       , Gs^Es       , Gs^Es       , Gs^Es       , Gs^Es       , Gs^Es       , Gs^Es       , Gs^Es       , Gs^Es       , Gs^Es       , Gs^Es       , Gs^Es       , Gs^Es       , Gs^Es       , Gs^Es       , Gs^Es       , Gs^Es       , Gs^Es       , Gs^Es       , Gs^Es       , Gs^Es       , Gs^Es       , Gs^Es       , Gs^Es       , Gs^Es       , Gs^Es       , Gs^Es       , Gs^Es       , Gs^Es       , Gs^Es       , Gs^Es       , Gs^Es       , Gs^Es       , Gs^Es       , Gs^Es       , Gs^Es       , Gs^Es       , Gs^Es       , Gs^Es       
Gs^Es       , Gs^Es       , Gs^Es       , Gs^Es       , Gs^Es       , Gs^Es       , Gs^Es       , Gs^Es       , Gs^Es       , Gs^Es       , Gs^Es       , Gs^Es       , Gs^Es       , Gs^Es       , Gs^Es       , Gs^Es       , Gs^Es       , Gs^Es       , Gs^Es       , Gs^Es       , Gs^Es       , Gs^Es       , Gs^Es       , Gs^Es       , Gs^Es       , Gs^Es       , Gs^Es       , Gs^Es       , Gs^Es       , Gs^Es       , Gs^Es       , Gs^Es       , Gs^Es       , Gs^Es       , Gs^Es       , Gs^Es       , Gs^Es       , Gs^Es       , Gs^Es       , Gs^Es       , Gs^Es       , Gs^Es       , Gs^Es       , Gs^Es       , Gs^Es       , Gs^Es       
Gs^Es       , Gs^Es       , Gs^Es       , Gs^Es       , Gs^Es       , Gs^Es       , Gs^Es       , Gs^Es       , Gs^Es       , Gs^Es       , Gs^Es       , Gs^Es       , Gs^Es       , Gs^Es       , Gs^Es       , Gs^Es       , Gs^Es       , Gs^Es       , Gs^Es       , Gs^Es       , Gs^Es       , Gs^Es       , Gs^Es       , Gs^Es       , Gs^Es       , Gs^Es       , Gs^Es       , Gs^Es       , Gs^Es       , Gs^Es       , Gs^Es       , Gs^Es       , Gs^Es       , Gs^Es       , Gs^Es       , Gs^Es       , Gs^Es       , Gs^Es       , Gs^Es       , Gs^Es       , Gs^Es       , Gs^Es       , Gs^Es       , Gs^Es       , Gs^Es       , Gs^Es       
Gs^Es       , Gs^Es       , Gs^Es       , Gs^Es       , Gs^Es       , Gs^Es       , Gs^Es       , Gs^Es       , Gs^Es       , Gs^Es       , Gs^Es       , Gs^Es       , Gs^Es       , Gs^Es       , Gs^Es       , Gs^Es       , Gs^Es       , Gs^Es       , Gs^Es       , Gs^Es       , Gs^Es       , Gs^Es       , Gs^Es       , Gs^Es       , Gs^Es       , Gs^Es       , Gs^Es       , Gs^Es       , Gs^Es       , Gs^Es       , Gs^Es       , Gs^Es       , Gs^Es       , Gs^Es       , Gs^Es       , Gs^Es       , Gs^Es       , Gs^Es       , Gs^Es       , Gs^Es       , Gs^Es       , Gs^Es       , Gs^Es       , Gs^Es       , Gs^Es       , Gs^Es       
Gs^Es       , Gs^Es       , Gs^Es       , Gs^Es       , Gs^Es       , Gs^Es       , Gs^Es       , Gs^Es       , Gs^Es       , Gs^Es       , Gs^Es       , Gs^Es       , Gs^Es       , Gs^Es       , Gs^Es       , Gs^Es       , Gs^Es       , Gs^Es       , Gs^Es       , Gs^Es       , Gs^Es       , Gs^Es       , Gs^Es       , Gs^Es       , Gs^Es       , Gs^Es       , Gs^Es       , Gs^Es       , Gs^Es       , Gs^Es       , Gs^Es       , Gs^Es       , Gs^Es       , Gs^Es       , Gs^Es       , Gs^Es       , Gs^Es       , Gs^Es       , Gs^Es       , Gs^Es       , Gs^Es       , Gs^Es       , Gs^Es       , Gs^Es       , Gs^Es       , Gs^Es       
Gs^Es       , Gs^Es       , Gs^Es       , Gs^Es       , Gs^Es       , Gs^Es       , Gs^Es       , Gs^Es       , Gs^Es       , Gs^Es       , Gs^Es       , Gs^Es       , Gs^Es       , Gs^Es       , Gs^Es       , Gs^Es       , Gs^Es       , Gs^Es       , Gs^Es       , Gs^Es       , Gs^Es       , Gs^Es       , Gs^Es       , Gs^Es       , Gs^Es       , Gs^Es       , Gs^Es       , Gs^Es       , Gs^Es       , Gs^Es       , Gs^Es       , Gs^Es       , Gs^Es       , Gs^Es       , Gs^Es       , Gs^Es       , Gs^Es       , Gs^Es       , Gs^Es       , Gs^Es       , Gs^Es       , Gs^Es       , Gs^Es       , Gs^Es       , Gs^Es       , Gs^Es       
Gs^Es       , Gs^Es       , Gs^Es       , Gs^Es       , Gs^Es       , Gs^Es       , Gs^Es       , Gs^Es       , Gs^Es       , Gs^Es       , Gs^Es       , Gs^Es       , Gs^Es       , Gs^Es       , Gs^Es       , Gs^Es       , Gs^Es       , Gs^Es       , Gs^Es       , Gs^Es       , Gs^Es       , Gs^Es       , Gs^Es       , Gs^Es       , Gs^Es       , Gs^Es       , Gs^Es       , Gs^Es       , Gs^Es       , Gs^Es       , Gs^Es       , Gs^Es       , Gs^Es       , Gs^Es       , Gs^Es       , Gs^Es       , Gs^Es       , Gs^Es       , Gs^Es       , Gs^Es       , Gs^Es       , Gs^Es       , Gs^Es       , Gs^Es       , Gs^Es       , Gs^Es       
Gs^Es       , Gs^Es       , Gs^Es       , Gs^Es       , Gs^Es       , Gs^Es       , Gs^Es       , Gs^Es       , Gs^Es       , Gs^Es       , Gs^Es       , Gs^Es       , Gs^Es       , Gs^Es       , Gs^Es       , Gs^Es       , Gs^Es       , Gs^Es       , Gs^Es       , Gs^Es       , Gs^Es       , Gs^Es       , Gs^Es       , Gs^Es       , Gs^Es       , Gs^Es       , Gs^Es       , Gs^Es       , Gs^Es       , Gs^Es       , Gs^Es       , Gs^Es       , Gs^Es       , Gs^Es       , Gs^Es       , Gs^Es       , Gs^Es       , Gs^Es       , Gs^Es       , Gs^Es       , Gs^Es       , Gs^Es       , Gs^Es       , Gs^Es       , Gs^Es       , Gs^Es       
Gs^Es       , Gs^Es       , Gs^Es       , Gs^Es       , Gs^Es       , Gs^Es       , Gs^Es       , Gs^Es       , Gs^Es       , Gs^Es       , Gs^Es       , Gs^Es       , Gs^Es       , Gs^Es       , Gs^Es       , Gs^Es       , Gs^Es       , Gs^Es       , Gs^Es       , Gs^Es       , Gs^Es       , Gs^Es       , Gs^Es       , Gs^Es       , Gs^Es       , Gs^Es       , Gs^Es       , Gs^Es       , Gs^Es       , Gs^Es       , Gs^Es       , Gs^Es       , Gs^Es       , Gs^Es       , Gs^Es       , Gs^Es       , Gs^Es       , Gs^Es       , Gs^Es       , Gs^Es       , Gs^Es       , Gs^Es       , Gs^Es       , Gs^Es       , Gs^Es       , Gs^Es       
Gs^Es       , Gs^Es       , Gs^Es       , Gs^Es       , Gs^Es       , Gs^Es       , Gs^Es       , Gs^Es       , Gs^Es       , Gs^Es       , Gs^Es       , Gs^Es       , Gs^Es       , Gs^Es       , Gs^Es       , Gs^Es       , Gs^Es       , Gs^Es       , Gs^Es       , Gs^Es       , Gs^Es       , Gs^Es       , Gs^Es       , Gs^Es       , Gs^Es       , Gs^Es       , Gs^Es       , Gs^Es       , Gs^Es       , Gs^Es       , Gs^Es       , Gs^Es       , Gs^Es       , Gs^Es       , Gs^Es       , Gs^Es       , Gs^Es       , Gs^Es       , Gs^Es       , Gs^Es       , Gs^Es       , Gs^Es       , Gs^Es       , Gs^Es       , Gs^Es       , Gs^Es       
Gs^Es       , Gs^Es       , Gs^Es       , Gs^Es       , Gs^Es       , Gs^Es       , Gs^Es       , Gs^Es       , Gs^Es       , Gs^Es       , Gs^Es       , Gs^Es       , Gs^Es       , Gs^Es       , Gs^Es       , Gs^Es       , Gs^Es       , Gs^Es       , Gs^Es       , Gs^Es       , Gs^Es       , Gs^Es       , Gs^Es       , Gs^Es       , Gs^Es       , Gs^Es       , Gs^Es       , Gs^Es       , Gs^Es       , Gs^Es       , Gs^Es       , Gs^Es       , Gs^Es       , Gs^Es       , Gs^Es       , Gs^Es       , Gs^Es       , Gs^Es       , Gs^Es       , Gs^Es       , Gs^Es       , Gs^Es       , Gs^Es       , Gs^Es       , Gs^Es       , Gs^Es       
Gs^Es       , Gs^Es       , Gs^Es       , Gs^Es       , Gs^Es       , Gs^Es       , Gs^Es       , Gs^Es       , Gs^Es       , Gs^Es       , Gs^Es       , Gs^Es       , Gs^Es       , Gs^Es       , Gs^Es       , Gs^Es       , Gs^Es       , Gs^Es       , Gs^Es       , Gs^Es       , Gs^Es       , Gs^Es       , Gs^Es       , Gs^Es       , Gs^Es       , Gs^Es       , Gs^Es       , Gs^Es       , Gs^Es       , Gs^Es       , Gs^Es       , Gs^Es       , Gs^Es       , Gs^Es       , Gs^Es       , Gs^Es       , Gs^Es       , Gs^Es       , Gs^Es       , Gs^Es       , Gs^Es       , Gs^Es       , Gs^Es       , Gs^Es       , Gs^Es       , Gs^Es       
Gs^Es       , Gs^Es       , Gs^Es       , Gs^Es       , Gs^Es       , Gs^Es       , Gs^Es       , Gs^Es       , Gs^Es       , Gs^Es       , Gs^Es       , Gs^Es       , Gs^Es       , Gs^Es       , Gs^Es       , Gs^Es       , Gs^Es       , Gs^Es       , Gs^Es       , Gs^Es       , Gs^Es       , Gs^Es       , Gs^Es       , Gs^Es       , Gs^Es       , Gs^Es       , Gs^Es       , Gs^Es       , Gs^Es       , Gs^Es       , Gs^Es       , Gs^Es       , Gs^Es       , Gs^Es       , Gs^Es       , Gs^Es       , Gs^Es       , Gs^Es       , Gs^Es       , Gs^Es       , Gs^Es       , Gs^Es       , Gs^Es       , Gs^Es       , Gs^Es       , Gs^Es       
Gs^Es       , Gs^Es       , Gs^Es       , Gs^Es       , Gs^Es       , Gs^Es       , Gs^Es       , Gs^Es       , Gs^Es       , Gs^Es       , Gs^Es       , Gs^Es       , Gs^Es       , Gs^Es       , Md          , Gs^Es       , Md          , Gs^Es       , Gs^Es       , Gs^Es       , Gs^Es       , Gs^Es       , Gs^Es       , Gs^Es       , Gs^Es       , Gs^Es       , Gs^Es       , Gs^Es       , Gs^Es       , Gs^Es       , Gs^Es       , Gs^Es       , Gs^Es       , Gs^Es       , Gs^Es       , Gs^Es       , Gs^Es       , Gs^Es       , Gs^Es       , Gs^Es       , Gs^Es       , Gs^Es       , Gs^Es       , Gs^Es       , Gs^Es       , Gs^Es       
Gs^Es       , Gs^Es       , Gs^Es       , Gs^Es       , Gs^Es       , Gs^Es       , Gs^Es       , Gs^Es       , Gs^Es       , Gs^Es       , Gs^Es       , Gs^Es       , Gs^Es       , Gs^Es       , Md          , Md          , Md          , Md          , Md          , Gs^Es       , Gs^Es       , Gs^Es       , Gs^Es       , Gs^Es       , Gs^Es       , Gs^Es       , Gs^Es       , Gs^Es       , Gs^Es       , Gs^Es       , Gs^Es       , Gs^Es       , Gs^Es       , Gs^Es       , Gs^Es       , Gs^Es       , Gs^Es       , Gs^Es       , Gs^Es       , Gs^Es       , Gs^Es       , Gs^Es       , Gs^Es       , Gs^Es       , Gs^Es       , Gs^Es       
Gs^Es       , Gs^Es       , Gs^Es       , Gs^Es       , Gs^Es       , Gs^Es       , Gs^Es       , Gs^Es       , Gs^Es       , Gs^Es       , Gs^Es       , Gs^Es       , Gs^Es       , Gs^Es       , Md          , Md          , Md          , Md          , Md          , Md          , 2 Md        , Gs^Es       , Gs^Es       , Gs^Es       , Gs^Es       , Gs^Es       , Gs^Es       , Gs^Es       , Gs^Es       , Gs^Es       , Gs^Es       , Gs^Es       , Gs^Es       , Gs^Es       , Gs^Es       , Gs^Es       , Gs^Es       , Gs^Es       , Gs^Es       , Gs^Es       , Gs^Es       , Gs^Es       , Gs^Es       , Gs^Es       , Gs^Es       , Gs^Es       
Gs^Es       , Gs^Es       , Gs^Es       , Gs^Es       , Gs^Es       , Gs^Es       , Gs^Es       , Gs^Es       , Gs^Es       , Gs^Es       , Gs^Es       , Gs^Es       , Gs^Es       , Hhd         , Hhd         , Md          , Md          , Md          , Md          , Md          , Md          , Md          , Md          , Gs^Es       , Gs^Es       , Gs^Es       , Gs^Es       , Gs^Es       , Gs^Es       , Gs^Es       , Gs^Es       , Gs^Es       , Gs^Es       , Gs^Es       , Gs^Es       , Gs^Es       , Gs^Es       , Gs^Es       , Gs^Es       , Gs^Es       , Gs^Es       , Gs^Es       , Gs^Es       , Gs^Es       , Gs^Es       , Gs^Es       
Gs^Es       , Gs^Es       , Gs^Es       , Gs^Es       , Gs^Es       , Gs^Es       , Gs^Es       , Gs^Es       , Gs^Es       , Gs^Es       , Gs^Es       , Gs^Es       , Gs^Es       , Hhd^Vhhr    , Hhd         , Hhd         , Md          , Md          , Md          , Md          , Md          , Md          , Gs^Es       , Gs^Es       , Gs^Es       , Gs^Es       , Gs^Es       , Gs^Es       , Gs^Es       , Gs^Es       , Gs^Es       , Gs^Es       , Gs^Es       , Gs^Es       , Gs^Es       , Gs^Es       , Gs^Es       , Gs^Es       , Gs^Es       , Gs^Es       , Gs^Es       , Gs^Es       , Gs^Es       , Gs^Es       , Gs^Es       , Gs^Es       
Gs^Es       , Gs^Es       , Gs^Es       , Gs^Es       , Gs^Es       , Gs^Es       , Gs^Es       , Gs^Es       , Gs^Es       , Gs^Es       , 1 Gs^Es     , Gs^Es       , Gs^Es       , Gs^Es       , Hhd^Vhhr    , Hhd         , Md          , Md          , Md          , Md          , Md          , Gs^Es       , Gs^Es       , Gs^Es       , Gs^Es       , Gs^Es       , Gs^Es       , Gs^Es       , Gs^Es       , Gs^Es       , Gs^Es       , Gs^Es       , Gs^Es       , Gs^Es       , Gs^Es       , Gs^Es       , Gs^Es       , Gs^Es       , Gs^Es       , Gs^Es       , Gs^Es       , Gs^Es       , Gs^Es       , Gs^Es       , Gs^Es       , Gs^Es       
Gs^Es       , Gs^Es       , Gs^Es       , Gs^Es       , Gs^Es       , Gs^Es       , Gs^Es       , Gs^Es       , Gs^Es       , Gs^Es       , Gs^Es       , Gs^Es       , Gs^Es       , Gs^Es       , Gs^Es       , Hhd         , Md          , Md          , Md          , Md          , Gs^Es       , Gs^Es       , Gs^Es       , Gs^Es       , Gs^Es       , Gs^Es       , Gs^Es       , Gs^Es       , Gs^Es       , Gs^Es       , Gs^Es       , Gs^Es       , Gs^Es       , Gs^Es       , Gs^Es       , Gs^Es       , Gs^Es       , Gs^Es       , Gs^Es       , Gs^Es       , Gs^Es       , Gs^Es       , Gs^Es       , Gs^Es       , Gs^Es       , Gs^Es       
Gs^Es       , Gs^Es       , Gs^Es       , Gs^Es       , Gs^Es       , Gs^Es       , Gs^Es       , Gs^Es       , Gs^Es       , Gs^Es       , Gs^Es       , Gs^Es       , Gs^Es       , Gs^Es       , Gs^Es       , Gs^Es       , Gs^Es       , Md          , Md          , Gs^Es       , Gs^Es       , Gs^Es       , Gs^Es       , Gs^Es       , Gs^Es       , Gs^Es       , Gs^Es       , Gs^Es       , Gs^Es       , Gs^Es       , Gs^Es       , Gs^Es       , Gs^Es       , Gs^Es       , Gs^Es       , Gs^Es       , Gs^Es       , Gs^Es       , Gs^Es       , Gs^Es       , Gs^Es       , Gs^Es       , Gs^Es       , Gs^Es       , Gs^Es       , Gs^Es       
Gs^Es       , Gs^Es       , Gs^Es       , Gs^Es       , Gs^Es       , Gs^Es       , Gs^Es       , Gs^Es       , Gs^Es       , Gs^Es       , Gs^Es       , Gs^Es       , Gs^Es       , Gs^Es       , Gs^Es       , Gs^Es       , Gs^Es       , Gs^Es       , Gs^Es       , Gs^Es       , Gs^Es       , Gs^Es       , Gs^Es       , Gs^Es       , Gs^Es       , Gs^Es       , Gs^Es       , Gs^Es       , Gs^Es       , Gs^Es       , Gs^Es       , Gs^Es       , Gs^Es       , Gs^Es       , Gs^Es       , Gs^Es       , Gs^Es       , Gs^Es       , Gs^Es       , Gs^Es       , Gs^Es       , Gs^Es       , Gs^Es       , Gs^Es       , Gs^Es       , Gs^Es       
Gs^Es       , Gs^Es       , Gs^Es       , Gs^Es       , Gs^Es       , Gs^Es       , Gs^Es       , Gs^Es       , Gs^Es       , Gs^Es       , Gs^Es       , Gs^Es       , Gs^Es       , Gs^Es       , Gs^Es       , Gs^Es       , Gs^Es       , Gs^Es       , Gs^Es       , Gs^Es       , Gs^Es       , Gs^Es       , Gs^Es       , Gs^Es       , Gs^Es       , Gs^Es       , Gs^Es       , Gs^Es       , Gs^Es       , Gs^Es       , Gs^Es       , Gs^Es       , Gs^Es       , Gs^Es       , Gs^Es       , Gs^Es       , Gs^Es       , Gs^Es       , Gs^Es       , Gs^Es       , Gs^Es       , Gs^Es       , Gs^Es       , Gs^Es       , Gs^Es       , Gs^Es       
